0000011000
2220000000
0000333300
4000000000
4000000000
4000000000
4000000000
4000000000
0000000055
0000000000