0000000001
0000222001
0044444000
0000000000
0000333300
0000000000
0000500000
0000500000
0000000000
0000000000