0030000000
0030000000
0030000000
0030000000
0000110002
0000000002
0000000002
0000000000
0000000055
0000444440